Plan B - She Said
Bruno Mars - Just The Way You Are
Katy Perry - California Gurls (feat Snoop Dogg)
Robbie Williams & Gary Barlow- Shame
Flo Rida - Club Can't Handle Me (feat David Guetta)
JLS - This Club Is Alive
Alexandra Burke - All Night Long (feat Pitbull)
B.o.B - Airplanes (feat Hayley Williams)
Black Eyed Peas - Imma Be
Travie McCoy - Billionaire (feat Bruno Mars)
Mike Posner - Cooler Than Me
Paloma Faith - New York
Olly Murs - Please Don't Let Me Go
Michael Buble - Hollywood
Gorillaz - Stylo
Paul Weller - No Tears To Cry
The XX - Islands
Vampire Weekend - Cousins
Biffy Clyro - Many Of Horror (When We Collide)
Kings Of Leon - Radioactive
Disc: 2
Tinie Tempah - Pass Out
Cee Lo Green - Forget You
Taio Cruz - Dynamite
Usher - OMG (feat Will.I.Am)
Cheryl Cole - Parachute
Jason Derulo - Ridin' Solo
Alicia Keys - Try Sleeping With A Broken Heart
Lady Gaga - Alejandro
Rumer - Slow
Ellie Goulding - Starry Eyed
Pixie Lott - Cry Me Out
The Wanted - All Time Low
Scouting For Girls - This Ain't A Love Song
Owl City - Fireflies
Eliza Doolittle - Pack Up
David Guetta - Getting Over You (feat Chris Wills)
Mark Ronson & The Business International - Bang Bang Bang
Dizzee Rascal - Dirtee Disco
Professor Green - Need You Tonight (feat Ed. Drewett)
Florence + The Machine & Dizzee Rascal - You've Got The Dirtee Love (Live At The Brit Awards 2010)
Disc: 3
Adele - Rolling In The Deep
Amy Winehouse - Rehab
Leona Lewis - Bleeding Love
Kate Nash - Foundations
The Noisettes - Donâ€™t Upset The Rhythm(Go Baby Go)
Katie B- Katy On A Mission
Aggro Santos - Candy
Master Shortie - Rope Chain
Bashy - When The Sky Falls
Jack McManus - Either Side Of Midnight
The Feeling - Never Been Lonely
Athlete - Wires
Floetry - Say Yes
Another Level- Freek Me
Damage - Love II Love
ROX - My Baby Left Me
Joe Worriker - We Hug In Bed
Imogen Heap - Hide & Seek
Charlene Soraia - Daffodils
Katie Melua - The Closest Thing To Crazy
